abandoned	bi bo roi, bi ruong bo
ability	kha nang, nang luc
able	co nang luc, co tai
unable	khong co nang luc
about	khoang, ve
above	o tren, len tren
abroad	o, ra nuoc ngoai
absent	vang mat
absolute	tuyet doi hoan toan
absorb	thu hut, hap dan
abuse	long hanh, lam dung
academic	thuoc hoc vien, dh, vien han lam
accept	chap nhan, chap thuan
accent	trong am, dau trong am
acceptable	co the chap nhan
unacceptable	khong the chap nhan
access	loi, cua, duong vao
accident	tai nan, rui ro
accidental	tonh co, bat ngo
accommodation	su thich nghi, dieu tiet
accopany	di theo, di cung
according	theo nhu
account	tai khoan, ke toan
accurate	dung dan, chinh xac
accuse	to cao, buoc toi
achieve	dat duoc, gianh duoc
achievement	thanh tich, thanh tuu
acid	axit
acknowledge	cong nhan, thua nhan
acquire	danh duoc, dat duoc
across	qua, ngang qua
act	hanh dong, hanh vi
action	hanh vi, dong tac
active	tich cuc hoat dong, nhanh nhen
actor	dien vien nam
actress	dien vien nu
actual	thuc te, co that
actually	hien nay, hien tai
adapt	tra, lap vao
add	cong, them vao
addition	tinh cong, phep cong
additional	them vao, tang them
address	dia chi, de dia chi
adequate	day, day du
adequately	tuong xung, thoa dang
adjust	sua lai cho dung, dieu chinh
admiration	su kham phuc,nguoi kham phuc, than phuc
admire	kham phuc, than phuc
admit	nhan vao, cho vao, ket hop
adopt	nhan lam con nuoi, bo me nuoi
adult	nguoi lon, nguoi truong thanh; truong thanh
advance	su tien bo, tien len; dua len, de xuat
advanced	tien tien, tien bo, cap cao
advantage	su thuan loi, loi ich, loi the
adventure	su phieu luu, mao hiem
advertise	bao cho biet, bao cho biet truoc
advertising	su quang cao, nghe quang cao
advertisement	quang cao
advice	loi khuyen, loi chi bao
advise	khuyen, khuyen bao, ran bao
affair	viec
affect	lam anh huong, tac dong den
affection	tonh cam, cam xyc
afford	co the, co du kha nang, dieu kien (lam go)
afraid	so, so hoi, hoang so
after	sau, dang sau, sau khi
afternoon	buoi chieu
afterwards	sau này, ve sau, roi tho, sau day
again	lai, nua, lan nua
against	chong lai, phan doi
age	tuoi
aged	gia di
agency	tac dung, luc; moi gioi, trung gian
agent	dai ly, tac nhan
aggressive	xam luoc, hung hang (US: xong xao)
ago	truoc day
agree	dong y, tan thanh
agreement	su dong y, tan thanh; hiep dinh, hop dong
ahead	truoc, ve phia truoc
aid	su giup do; them vao, phu vao
aim	su nham (ban), muc tiou, y dinh; nham, tap trung, huong vao
air	khong khi, bau khong khi, khong gian
aircraft	may bay, tau bay, khi cau
airport	san bay, phi truong
alarm	bao dong, bao nguy
alarming	làm lo so, làm hot hoang, làm so hoi
alarmed	bao dong
alcohol	ruou con
alcoholic	ruou, nguoi nghien ruou
alive	song, van cun song, cun ton tai
all	tat ca
allow	cho phep, de cho
all	tot, on, khoe manh; duoc
ally	nuoc dong minh, lien minh; lien ket, ket thong gia
allied	lien minh, dong minh, thong gia
almost	hau nhu, gan nhu
alone	co don, mot monh
along	doc theo, theo; theo chieu dai, suot theo
alongside	sat canh, ke ben, doc theo
aloud	lon tieng, to tieng
alphabet	bang chu cai, buoc dau, dieu co ban
alphabetical	thuoc bang chu cai
already	do, roi, do… roi
also	cung, cung vay, cung the
alter	thay doi, bien doi, sua doi
alternative	su lua chon; lua chon
alternatively	nhu mot su lua chon
although	mac du, dau cho
altogether	hoan toan, hau nhu; noi chung
always	luon luon
amaze	lam ngac nhien, lam sung sot
amazing	kinh ngac, sung sot,lam het suc ngac nhien
amazedly	kinh ngac, sung sot, het suc ngac nhien
ambition	hoài boo, khot vong
ambulance	xe cuu thuong, xe cap cuu
among	giua, o giua
amount	so luong, so nhieu; len toi (money)
amuse	lam cho vui, thich, lam buon cuoi,thich thu
amusing	vui, lam cho buon cuoi
amusable	co the lam vui duoc, co the giai tri duoc
analyse	phan tich
analysis	su phan tich
ancient	xua, co
and	va
anger	su tuc gian, su gian du
angle	goc
angry	gian, tuc gian
angrily	tuc gian, gian du
animal	dong vat, thu vat
ankle	mat ca chan
anniversary	ngay, le ki niem
announce	bao, thong bao
annoy	choc tuc, làm buc monh; làm phien, quay nhieu
annoying	choc tuc, làm buc monh; làm phien, quay nhieu
annoyed	bi khu chiu, buc monh, bi quay ray
annual	hang nam, tung nam
annually	hang nam, tung nam
another	khac
answer	su tra loi; tra loi
anticipate	thay truoc, chan truoc, luong truoc
anxiety	moi lo au, su lo lang
anxious	lo au, lo lang, ban khoan
anxiously	lo au, lo lang, ban khoan
any	mot nguoi, vat nao do; bat cu; mot chut nao, ti nao
anyone	nguoi nao, bat cu ai
anything	viec go, vat go; bat cu viec go, vat go
anyway	the nao cung duoc, du sao chang nua
anywhere	bat cu cho nao, bat cu noi dau
apart	ve mot ben, qua mot ben
apartment	can phung, can buong
apologize	xin loi, ta loi
apparent	ru ràng, rành mach; be ngoài, co ve
apparently	nhon bon ngoài, honh nhu
appeal	su keu goi, loi keu goi; keu goi, cau khan
appear	xuat hien, hien ra, tronh dien
appearance	su xuat hien, su tronh dien
apple	qua tao
application	su gan vao, vat gan vao; su chuyen can, chuyen tam
apply	gan vao, ghep vao, ap dung vao
appoint	bo nhiem, chi dinh, chon
appointment	su bo nhiem, nguoi duoc bo nhiem
appreciate	thay ru; nhan thuc
approach	den gan, lai gan; su den gan, su lai gan
appropriate	thich hop, thich dang
approval	su tan thanh, dong y, su chap thuan
approve	tan thanh, dong y, chap thuan
approving	tan thanh, dong y, chap thuan
approximate	giong voi, giong het voi
approximately	khoang chung, do chung
April	thang Tu
area	dien tich, be mat
argue	chung to, chi ru
argument	ly le
arise	xuat hien, nay ra, nay sinh ra
arm	canh tay; vu trang, trang bi (vu khi)
arms	vu khi, binh gioi, binh khi
armed	vu trang
army	quan doi
around	xung quanh, vung quanh
arrange	sap xep, sap dat, sua soan
arrangement	su sap xep, sap dat, su sua soan
arrest	bat giu, su bat giu
arrival	su den, su toi noi
arrive	den, toi noi
arrow	ten, mui ten
art	nghe thuat, my thuat
article	bai bao, de muc
artificial	nhan tao
artist	nghe si
artistic	thuoc nghe thuat, thuoc my thuat
as	nhu
ashamed	nguong, xau ho
aside	ve mot ben, sang mot ben
asleep	ngu, dang ngu
fall asleep	ngu thiep di
aspect	ve be ngoai, dien mao
assist	giup, giup do; tham du, co mat
assistance	su giup do
assistant	nguoi giup do, nguoi phu ta; giup do
associate	ket giao, lien ket, ket hop, cho cong tac
associated with	lien ket voi
association	su ket hop, su lien ket
assume	mang, khoac, co, lay (cai ve, tinh chat…)
assure	dam bao, cam doan
atmosphere	khi quyen
atom	nguyen tu
attach	gan, dan, troi, buoc
attached	gan bo
attack	su tan cong, su cong kich; tan cong, cong kich
attempt	su co gang, su thu; co gang, thu
attempted	co gang, thu
attend	du, co mat
attention	su chy y
pay attention	chy y toi
attitude	thai do, quan diem
attorney	nguoi duoc uy quyen
attract	hut; thu hut, hap dan
attraction	su hut, suc hut
attractive	hut, thu hut, co duyen, loi cuon
audience	thinh, khan gia
August	thang Tam
aunt	cu, do
author	tac gia
authority	uy quyen, quyen luc
automatic	tu dong
automatically	mot cach tu dong
autumn	mua thu (US: mua thu la fall)
available	co the dung duoc, co gia tri, hieu luc
average	trung bonh, so trung bonh, muc trung bonh
avoid	tranh, tranh xa
awake	danh thuc, lam thuc day
award	phan thuong; tang, thuong
aware	biet, nhan thuc, nhan thuc thay
away	xa, xa cach, roi xa, di xa
awful	oai nghiem, de so
awfully	tan khoc, khung khiep
awkward	vung ve, lung tung
awkwardly	vung ve, lung tung
back	lung, ve phia sau, tro lai
background	phia sau; nen
backward	ve phia sau, lui lai
bacteria	vi khuan
bad	xau, toi
go bad	ban thiu, thoi, hong
badly	xau, toi
bad-tempered	xau tinh, de noi cau
bag	bao, tui, cap xach
baggage	hành ly
bake	nung, nuong bang lu
balance	cai can; lam cho can bang, tuong xung
ball	qua bong
ban	cam, cam chi; su cam
band	bang, dai, nep
bandage	dai bang; bang bo
bank	bo (song…) , de
bar	quan ban ruou
bargain	su mac ca, su giao keo mua ban
barrier	dat chuong ngai vat
base	co so, co ban, nen mong; dat ten, dat co so tren cai go
based on	dua tren
basic	co ban, co so
basically	co ban, ve co ban
basis	nen tang, co so
bath	su tam
bathroom	buong tam, nha ve sinh
battery	pin, ac quy
battle	tran danh, chien thuat
bay	gian (nhà), nhip (cau), chuong (ngua); bays: vung nguyet que
beach	boi bien
beak	mo chim
bear	mang, cam, vac, deo, om
beard	rau
beat	tieng dap, su dap; danh dap, dam
beautiful	dep
beautifully	tot dep, dang hai lung
beauty	ve dep, cai dep
because	boi vo
become	tro thanh, tro nen
bed	cai giuong
bedroom	phung ngu
beef	thit bu
beer	ruou bia
before	truoc, dang truoc
begin	bat dau, khoi dau
beginning	phan dau, luc bat dau, luc khoi dau
behalf	su thay mat
behave	doi xu, an o, cu xu
behaviour	cach doi xu, cach an o,tu cach dao duc
behind	sau, o dang sau
belief	lung tin, duc tin, su tin tuong
believe	tin, tin tuong
bell	cai chuong, tieng chuong
belong	thuoc ve, cua, thuoc quyen so huu
below	o duoi, duoi thap, phia duoi
belt	day lung, that lung
bend	cho re, cho uon; khuyu tay; cui xuong, uon cong
bent	khieu, so thich, khuynh huong
beneath	o duoi, duoi thap
benefit	loi, loi ich; giup ich, lam loi cho
beside	ben canh, so voi
bet	danh cuoc, ca cuoc; su danh cuoc
betting	su danh cuoc
between	giua, o giua
beyond	o xa, phia ben kia
bicycle	xe dap
bid	dat gia, tra gia; su dat gia, su tra gia
big	to, lon
bill	hoa don, giay bac
bin	thung, thung dung ruou
biology	sinh vat hoc
bird	chim
birth	su ra doi, su sinh de
give birth	sinh ra
birthday	ngay sinh, sinh nhat
biscuit	banh quy
bit	mieng, manh
a bit	mot chyt, mot ty
bite	can, ngoam; su can, su ngoam
bitter	dang; dang cay, chua xot
bitterly	dang, dang cay, chua xot
black	den; mau den
blade	luoi (dao, kiem); la (co, cay); mai (cheo); canh (chong chong)
blame	khien trach, mang trach; su khien trach, su mang trach
blank	trong, de trang; su trong rong
blankly	ngay ra, khong co than
blind	dui, mu
block	khoi, tang (da); lam ngan can, ngan chan
blonde	co gai toc hoe, nguoi dan ba toc hoe
blond	vang hoe
blood	mau, huyet; su tan sat, chem giet
blow	no hoa; su no hoa
blue	xanh, mau xanh
board	tam van; lat van, lot van
on board	tren tau thuy
boat	tau, thuyen
body	than the, than xac
boil	soi, luoc
bomb	qua bom; danh bom, tha bom
bone	xuong
book	sach; ghi chep
boot	giay ong
border	bo, mep, via, le (duong)
bore	buon chan, buon te
boring	buon chan
bored	buon chan
born	sinh, de
borrow	vay, muon
boss	ong chu, thu truong
both	ca hai
bother	làm phien, quay ray, làm buc monh
bottle	chai, lo
bottom	phan duoi cung, thap nhat; cuoi, cuoi cung
bound	nhat dinh, chac chan
bowl	cai bat
box	hop, thung
brain	uc noo; dau oc, tri noo
branch	nganh; nhanh cay, nhanh song, nga duong
brand	nhon (hàng hua)
brave	gan da, can dam
bread	banh my
break	be goy, dap vo; su goy, su vo
broken	bi goy, bi vo
breakfast	bua diem tam, bua sang
breast	nguc, vu
breath	hoi tho, hoi
breathe	hit, tho
breathing	su ho hap, su tho
breed	nuoi duong, cham soc, giao duc; sinh de; nui giong
brick	gach
bridge	cai cau
brief	ngan, gon, van tat
briefly	ngan, gon, van tat, tom tat
bright	sang, sang choi
brightly	sang choi, tuoi
brilliant	toa sang, ruc ro, choi loi
bring	mang, cam , xach lai
broad	rong
broadly	rong, rong roi
broadcast	tung ra khap noi,truyen rong roi; phot thanh,quang bo
brown	nau, mau nau
brush	ban chai; chai, quet
bubble	bong bong, bot, tam
budget	ngan sach
build	xay dung
building	su xoy dung, cung tronh xoy dung; tua nhà
bullet	dan (sung truong, sung luc)
bunch	bui, chum, bo, cum, buong; bay, dan
burn	dot, dot chay, thap, nung, thieu
burnt	bi dot, bi chay, khe; ram nang, sam (da)
burst	no, no tung (bom, dan); no, vo (bong bong); hao huc
bury	chon cat, mai tang
bush	bui cay, bui ram
business	viec buon ban, thuong mai, kinh doanh
businessman	thuong nhan (nam)
businesswoman	thuong nhan (nu)
busy	ban, ban ron
butter	bo
button	cai nut, cai khuy, cuc
buy	mua
buyer	nguoi mua
by	boi, bang
cabinet	tu co nhieu ngan dung do
cable	day cap
cake	banh ngot
calculate	tinh toan
calculation	su tinh toan
call	goi; tieng keu, tieng goi
calm	yen lang, lam diu di; su yen lang, su em a
calmly	yon lang, om a; bonh tinh, diem tinh
camp	trai, cho cam trai; cam trai, ha trai
camping	su cam trai
campaign	chien dich, cuoc van dong
can	cu the; nhà tu, nhà giam, bonh, ca dung
could	co the
cancel	huy bo, xoa bo
cancer	benh ung thu
candidate	nguoi ung cu, thi sinh, nguoi du thi
candy	keo
cap	mu luoi trai, mu va
capable of	co tai, co nang luc; co kha nang, ca gan
capacity	nang luc, kha nang tiep thu, nang suat
capital	thu do, tien von; chu yeu, chinh yeu, co ban
captain	nguoi cam dau, nguoi chi huy, thu linh
capture	bat giu, bat; su bat giu, su bi bat
card	the, thiep
cardboard	boa cung, coc tung
care	su cham soc, cham nom; cham soc
take care of	su giu gon
care for	trong nom, cham soc
career	nghe nghiep, su nghiep
careful	can than, can trong, biet giu gon
carefully	can than, chu dao
careless	so suat, cau tha
carelessly	cau tha, bat can
carpet	tam tham, tham (co)
carrot	cu ca rot
carry	mang, vac, khuan cho
case	vo, ngan, tui
in case of	neu...
cash	tien, tien mat
cast	quang, nem, tha, danh guc; su quang, su nem (luoi), su tha (neo)
castle	thành tro, thành quoch
catch	bat lay, nam lay, tom lay, chop lay
category	hang, loai; pham tru
cause	nguyen nhan, nguyen do; gay ra, gay nen
cease	dung, ngung, ngot, thoi, het, tanh
ceiling	tran nha
celebrate	ky niem, lam le ky niem; tan duong, ca tung
celebration	su ky niem, le ky niem; su tan duong, su ca tung
cell	o, ngan
cent	dong xu
cellphone	dien thoai di dong
centimetre	xen ti met
central	trung tam, o giua, trung uong
centre	diem giua, trung tam, trung uong
century	the ky
ceremony	nghi thuc, nghi le
certain	chac chan
certainly	chac chan, nhat dinh
uncertain	thieu chinh xac, khong chac chan
certificate	giay chung nhan, bang, chung chi
chain	day, xich; xinh lai, troi lai
chair	ghe
chairman	chu tich, chu toa
chairwoman	nu chu tich
challenge	su thu thach, su thach thuc; thach thuc, thu thach
chamber	buong, phung, buong ngu
chance	su may man
change	thay doi, su thay doi, su bien doi
channel	kenh (TV, radio), eo bien
chapter	chuong (sach)
character	tinh cach, dac tinh, nhan vat
characteristic	rieng, rieng biet, dac trung, dac tinh, dac diem
charge	nhiem vu, bon phan, trach nhiem; giao nhiem vu, giao viec
in charge of	phu trach
charity	lung tu thien, lung nhon duc; su bo thi
chart	do thi, bieu do; ve do thi, lap bieu do
chase	san bat; su san bat
chat	noi chuyen, tan gau; chuyen phiem, chuyen gau
cheap	re
cheaply	re, re tien
cheat	lua, lua dao; tru lua dao, tru gian lan
check	kiem tra; su kiem tra
cheek	ma
cheerful	vui mung, phan khoi, ho hoi
cheerfully	vui ve, phan khoi
cheese	pho mat
chemical	thuoc hoa hoc; chat hoa hoc, hoa chat
chemist	nha hoa hoc
chemistry	hoa hoc, mon hoa hoc, nganh hoa hoc
cheque	sec
chest	tu, ruong, hum
chew	nhai, ngam nghi
chicken	ga, ga con, thit ga
chief	trong yeu, chonh yeu; thu linh, lonh tu, nguoi dung dau, sep
child	dua be, dua tre
chin	cam
chip	vo bao, manh vo, cho sut, me
choice	su lua chon
choose	chon, lua chon
chop	chat, don, che
church	nha tho
cigarette	dieu thuoc la
circle	duong trun, honh trun
circumstance	hoan canh, truong hop, tonh huong
citizen	nguoi thanh thi
city	thanh pho
civil	cong dan
claim	dui hoi, you soch; su dui hoi, su you soch, su thinh cau
clap	vo, vo tay; tieng no, tieng vo tay
classic	co dien, kinh dien
clean	sach, sach se
clear	lau chui, quet don
clearly	ru ràng, song sua
clerk	thu ky, linh muc, muc su
clever	lanh loi, thong minh. tai gioi, kheo leo
click	lam thanh tieng lach cach; tieng lach cach, cu nhap (chuot)
client	khach hang
climate	khi hau, thoi tiet
climb	leo, treo
climbing	su leo treo
clock	dong ho
close	gan (mqh), than thiet,chat che, dong, khep, ket thuc
closely	gan gui, than mat, chat che, ky luong, ti mi
closed	bao thu, khong coi mo, khep kin
closet	buong, phung de do, phung kho
cloth	vai, khan trai ban, ao thay tu
clothes	quan ao
clothing	quan ao, y phuc
cloud	may, dam may
club	cau lac bo; gay, dui cui
coach	huan luyen vien
coal	than da
coast	su lao doc; bo bien
coat	ao choang
code	mat mo, luat, dieu le
coin	tien kim loai
cold	lanh, su lanh leo, lanh nhat
coldly	lanh nhat, ho hung, vo tam
collapse	do, sup do; su do nat, su sup do
colleague	ban dong nghiep
collect	suu tap, tap trung lai
collection	su suu tap, su tu hop
college	truong cao dang
colour	mau sac; to mau
coloured	mang mau sac, co mau sac
column	cot , muc (bao)
combination	su ket hop, su phoi hop
combine	ket hop, phoi hop
come	den, toi, di den, di toi
comedy	hai kich
comfort	su an ui, khuyen giai, loi dong vien, su an nhan
comfortable	thoai mai, tien nghi, day du
comfortably	de chiu, thoai mai, tien nghi, am cung
uncomfortable	bat tien, kho chiu, khong thoai mai
command	ra lenh, chi huy; lenh, menh lenh, quyen ra lenh, quyen chi huy
comment	loi bonh luan, loi chy giai; bonh luan, pho bonh, chy thoch, dan giai
commercial	buon ban, thuong mai
commission	hoi dong, uy ban, su uy nhiem, su uy thac,
commit	giao, gui, uy nhiem, uy thac; tong giam, bo tu
commitment	su pham toi, su tan tuy, tan tam
committee	uy ban
common	cong, cong cong, thong thuong, pho bien
in common	su chung, cua chung
commonly	thong thuong, bonh thuong
communicate	truyen, truyen dat; giao thiep, lien lac
communication	su giao tiep, lien lac, su truyen dat, truyen tin
community	dan chung, nhan dan
company	cong ty
compare	so sanh, doi chieu
comparison	su so sanh
compete	dua tranh, ganh dua, canh tranh
competition	su canh tranh, cuoc thi, cuoc thi dau
competitive	canh tranh, dua tranh
complain	phan nan, keu ca
complaint	loi than phien, than tho; su khieu nai, don kien
complete	hoan thanh, xong
completely	hoan thanh, day du, tron ven
complex	phuc tap, rac roi
complicate	lam phuc tap, rac roi
complicated	phuc tap, rac roi
computer	may tinh
concentrate	tap trung
concentration	su tap trung, noi tap trung
concept	khai niem
concern	lien quan, dinh liu toi; su lien quan, su dinh liu toi
concerned	co lien quan, co dinh liu
concerning	bang khuang, ai ngai
concert	buoi hua nhac
conclude	ket luan, ket thuc, cham dut (cong viec)
conclusion	su ket thuc, su ket luan, phan ket luan
concrete	bang be tong; be tong
condition	dieu kien, tonh canh, tonh the
conduct	dieu khien, chi dao, chi huy; su dieu khien, chi huy
conference	hoi nghi, su ban bac
confidence	lung tin tuong, su tin cay
confident	tin tuong, tin cay, tu tin
confidently	tu tin
confine	giam giu, han che
confined	han che, gioi han
confirm	xac nhan, chung thuc
conflict	xung dot, va cham; su xung dot, su va cham
confront	doi mat, doi dien, doi chieu
confuse	lam lon xon, xao tron
confusing	kho hieu, gay boi roi
confused	boi roi, lung tung, nguong
confusion	su lon xon, su roi loan
congratulations	su chuc mung, khen ngoi; loi chuc mung, khen ngoi
congress	dai hoi, hoi nghi, Quoc hoi
connect	ket noi, noi
connection	su ket noi, su giao ket
conscious	tinh too, cu y thuc, biet ru
unconscious	bat tinh, khung cu y thuc, khung biet ru
consequence	ket qua, hau qua
conservative	than trong, de dat, bao thu
consider	can nhac, xem xet; de y, quan tam, luu y den
considerable	lon lao, to tat, dang ke
considerably	dang ke, lon lao, nhieu
consideration	su can nhac, su xem xet, su de y, su quan tam
consist of	gom co
constant	kion tro, ben lung
constantly	kien dinh
constantly	kien dinh
construct	xay dung
construction	su xoy dung, cung tronh
consult	tra cuu, tham khao, tham du, hoi y kien
consumer	nguoi tieu dung
contact	su lien lac, su giao thiep; tiep xuc
contain	bao ham, chua dung, bao gom
container	cai dung, chua; cong te no
contemporary	duong thoi, duong dai
content	noi dung, su hài lung
contest	cuoc thi, tran dau, cuoc tranh luan, cuoc chien dau,chien tranh
context	van canh, khung canh, pham vi
continent	luc dia, dai luc
continue	tiep tuc, lam tiep
continuous	lien tuc, lien tiep
continuously	lien tuc, lien tiep
contract	hop dong, su ky hop dong; ky ket
contrast	su tuong phan; lam tuong phan, trai nguoc
contrasting	tuong phan
contribute	dong gop, gop phan
contribution	su dong gop, su gop phan
control	su dieu khien, quyen hanh, quyen luc, quyen chi huy
in control of	trong su dieu khien cua...
under control	duoi su dieu khien cua...
controlled	duoc dieu khien, duoc kiem tra
uncontrolled	khong bi dieu khien, khong bi kiem tra, khong bi han che
convenient	tien loi, thuan loi, thich hop
conventio	hoi nghi, hiep dinh, quy uoc
conventional	quy uoc
conversation	cuoc dam thoai, cuoc tru chuyen
convert	doi, bien doi
convince	lam cho tin, thuyet phuc; lam cho nhan thuc thay
cook	nau an, nguoi nau an
cooking	su nau an, cach nau an
cooker	lu, bep, noi nau
cookie	banh quy
cool	mat me, diem tinh; lam mat
cope with	doi pho, duong dau
copy	ban sao, ban chep lai; su sao chep; sao chep, bat chuoc
core	nung cot, hat nhon; day lung
corner	goc (tuong, nha, pho...)
correct	dung, chinh xac; sua, sua chua
correctly	dung, chinh xac
cost	gia, chi phi; tra gia, phai tra
cottage	nha tranh
cotton	bong, chi, soi
cough	ho, su ho, tieng hoa
coughing	ho
council	hoi dong
count	dem, tinh
counter	quay hang, quay thu tien, may dem
country	nuoc, quoc gia, dat nuoc
countryside	mien que, mien nong thon
county	hat, tinh
couple	doi, cap
a couple	mot cap, mot doi
courage	can dam, su dung cam, dung khi
of course	di nhien
court	son, son (tennis...), tua on, quan tua, phion tua
cousin	anh em ho
cover	bao boc, che phu; vo, vo boc
covered	co mai che, kin dao
cow	con bu coi
crack	cu, xuat sac; lam nut, lam vo, nut ne, ran nut
cracked	ran, nut
craft	nghe, nghe thu cong
crash	vai tho; su roi (may bay), su pha san, sup do; pha tan tanh
crazy	dien, mat tri
cream	kem
create	sang tao, tao nen
creature	sinh vat, loai vat
credit	su tin, lung tin, danh tieng; tien gui ngon hàng
credit card	the tin dung
crime	toi, toi ac, toi pham
criminal	co toi, pham toi; ke pham toi, toi pham
crisis	su khung hoang, con khung hoang
crisp	giun
criterion	tieu chuan
critical	pho bonh, pho phon; khu tonh
criticism	su pho bonh, su pho phon, loi pho bonh, loi pho phon
criticize	pho bonh, pho phon, chi troch
crop	vu mua
cross	cay Thanh Gia, noi thong kho; su bang qua; bang qua, vuot qua
crowd	dam dong
crowded	dong duc
crown	vuong mien, vua, ngai vang; dinh cao nhat
crucial	quyet dinh, cot yeu, chu yeu
cruel	doc ac, du ton, tan nhan
crush	ep, vat, de nat, de bep
cry	khoc, keu la; su khoc, tieng khoc, su keu la
cultural	van hoa
culture	van hoa, su mo mang, su giao duc
cup	tach, chen
cupboard	1 loai tu co ngan
curb	kiem che, nen lai, han che
cure	chua tri, dieu tri; cach chua benh, cach dieu tri; thuoc
curious	ham muon, tu mu, la lung
curiously	tu mu, hieu ky, la ky
curl	quan, xoan, uon quan, lam xoan; su uon quan
curly	quan, xoan
current	hien hành, pho bien, hien nay; dung (nuoc), luong (gio)
currently	hien thoi, hien nay
curtain	man (cua, rap hat, khoi, suong)
curve	duong cong, duong vung; cong, uon cong, be cong
curved	cong
custom	phong tuc, tuc le, thoi quen, tap quan
customer	khach hang
customs	thue nhap khau, hai quan
cut	cat, chat; su cat
cycle	chu ky, chu tronh, vung; quay vung theo chu ky, di xe dap
cycling	su di xe dap
daily	hang ngay
damage	moi hai, dieu hai, su thiet hai; lam hu hai, lam hong
damp	am, am uot, am thap
dance	su nhay mua, su khieu vu; nhay mua, khieu vu
dancing	su nhay mua, su khieu vu
dancer	dien vien mua, nguoi nhay mua
danger	su nguy hiem, moi hiem ngheo; nguy co, moi de doa
dangerous	nguy hiem
dare	dam, dam duong dau voi; thach
dark	toi, toi tam; bong toi, am muoi
data	so lieu, du lieu
date	ngay, ky, ky han, thoi ky, thoi dai; de ngay thang
daughter	con gai
day	ngay, ban ngay
dead	chet, tat
deaf	diec, lam thinh, lam ngo
deal	phan phat, phan phoi; su giao dich, thoa thuan mua ban
deal with	giai quyet
dear	than, than yeu, than men; kinh thua, thua
death	su chet, cai chet
debate	cuoc tranh luan, cuoc tranh coi; tranh luan, bàn coi
debt	no
decade	thap ky, bo muoi, nhom muoi
decay	tonh trang suy tàn, suy sup, tonh trang do nat
december	thang muoi hai, thang Chap
decide	quyet dinh, giai quyet, phan xu
decision	su quyet dinh, su giai quyet, su phan xu
declare	tuyen bo, cong bo
decline	su suy tan, su suy sup; suy sup, suy tan
decorate	trang hoang, trang tri
decoration	su trang hoang, do trang hoang, trang tri
decorative	de trang hoang, de trang tri, de lam canh
decrease	giam bot, lam suy giam, su giam di, su giam sut
deep	sau, kho luong, bi an
deeply	sau, sau xa, sau sac
defeat	danh thang, danh bai; su that bai (1 ke hoach), su tieu tan (hy vong)
defence	cai de bao ve, vat de chong do, su che cho
defend	che cho, bao ve, bao chua
define	dinh nghia
definite	xac dinh, dinh ru, ru ràng
definitely	rach rui, dut khoot
definition	su dinh nghia, loi dinh nghia
degree	muc do, tronh do; bang cap; do
delay	su cham tre, su tro hoon, su can tro; làm cham tre
deliberate	than trong, co tinh toan, chu tam, co suy nghi can nhac
deliberately	than trong, co suy nghi can nhac
delicate	thanh nho, thanh ty, te nhi, khu xu
delight	su vui thich, su vui suong, dieu thich thu; lam vui thich, lam say me
delighted	vui mung, hài lung
deliver	cuu khoi, thoot khoi, bày to, gioi bày
delivery	su phan phat, su phan phoi, su giao hang; su bay to, phat bieu
demand	su dui hoi, su you cau; dui hoi, you cau
demonstrate	chung minh, giai thich; bay to, bieu lo
dentist	nha si
deny	tu choi, phan doi, phu nhan
department	cuc, so, ty, ban, khoa; gian hang, khu bay hang
departure	su roi khoi, su di, su khoi hanh
depend on	phu thuoc, tuy thuoc; dua vao, y vao, trong mong vao
deposit	vat gui, tien gui, tien dat coc; gui, dat coc
depress	lam chan nan, lam phien muon; lam suy giam
depressing	lam chan nan làm thot vong, làm tro tre
depressed	chan nan, that vong, phien muon; suy yeu, donh tre
depth	chieu sau, do day
derive	nhan duoc tu, lay duoc tu; xuat phat tu, bat nguon,chuyen hoa tu (from)
describe	dien ta, mieu ta, mo ta
description	su mo ta, su ta, su mieu ta
desert	sa mac; cong lao, gia tri; roi bo, bo tron
deserted	hoang vang, khong nguoi o
deserve	dang, xung dang
design	su thiet ke, ke hoach, de cuong. phac thao
desire	uoc muon; them muon, ao uoc
desk	ban (hoc sinh, viet, lam viec)
desperate	lieu mang, lieu linh; tuyet vong
desperately	lieu linh, lieu mang
despite	du, mac du, bat chap
destroy	pha, pha hoai, pha huy, tieu diet, triet pha
destruction	su pha hoai, su pha huy, su tieu diet
detail	chi tiet
in detail	tuong tan, ty mi
detailed	can ke, ti mi, nhieu chi tiet
determination	su xac dinh, su dinh ru; su quyet dinh
determine	xac dinh, dinh ru; quyet dinh
determined	do duoc xac dinh, do duoc xac dinh ru
develop	phot trien, mo rong; tronh bày, bày to
development	su phat trien, su tronh bày, su bày to
device	ke sach; thiet bi, dung cu, may moc
devote	hien dang, danh het cho
devoted	hien cho, dong cho, dành cho; het lung, nhiet tonh
diagram	bieu do
diamond	kim cuong
diary	so nhat ky; lich ghi nho
dictionary	tu dien
die	chet, tu tran, hy sinh
dying	su chet
diet	che do an uong, che do an kieng
difference	su khac nhau
different	khac, khac biet, khac nhau
differently	khac, khac biet, khac nhau
difficult	kho, kho khan, gay go
difficulty	su kho khan, noi kho khan, dieu can tro
dig	dao boi, xoi
dinner	bua trua, chieu
direct	truc tiep, thang, thang than; gui, viet cho ai, dieu khien
directly	truc tiep, thang
direction	su dieu khien, su chi huy
director	giam doc, nguoi dieu khien, chi huy
dirt	do ban thiu, do do ban, vat rac ruoi
dirty	ban thiu, do ban
disabled	bat luc, khong co kha nang
disadvantage	su bat loi, su thiet hai
disagree	bat dong, khong dong y, khac, khong giong; khong hop
disagreement	su bat dong, su khong dong y, su khac nhau
disappear	bien mat, bien di
disappoint	khong lam thoa uoc nguyen, y mong doi; that uoc,lam that bai
disappointing	lam chan ngan, lam that vong
disappointed	that vong
disappointment	su chan ngan, su that vong
disapproval	su phan doi, su khong tan thanh
disapprove of	khong tan thanh, phan doi, che
disapproving	phan doi
disaster	tai hoa, tham hoa
discipline	ky luat
discount	su bot gia, su chiet khau, tien bot, chiet khau
discover	kham pha, phat hien ra, nhan ra
discovery	su khom pho, su tom ra, su phot hien ra
discuss	thao luan, tranh luan
discussion	su thao luan, su tranh luan
disease	can benh, benh tat
disgust	lam ghe tom, lam kinh tom, lam phan no
disgusting	lam ghe tom, kinh tom
disgusted	chan ghet, phan no
dish	dia (dung thuc an)
dishonest	bat luong, khong thanh that
dishonestly	bat luong, khong luong thien
disk	dia, dia hat
dislike	su khong ua, khong thich, su ghet
dismiss	giai tan (quan doi, dam dong); sa thai (nguoi lam)
display	bay to, pho truong, trung bay; su bay ra, pho bay,trung bay
dissolve	tan ro, phon huy, giai ton
distance	khoang cach, tam xa
distinguish	phan biet, nhan ra, nghe ra
distribute	phan bo, phan phoi, sap xep, phan loai
distribution	su phan bo, su phan phoi, phan phat, su sap xep
district	huyen, quan
disturb	lam mat yen tinh, lam nao dong, quay ray
disturbing	xao tron
divide	chia, chia ra, phan ra
division	su chia, su phan chia, su phan loai
dissolve	tan ro, phon huy, giai ton
divorce	su ly di
divorced	do ly di
undo	thao, go; xoa bo, huy bo
doctor	bac si y khoa, tien si
document	van kien, tai lieu, tu lieu
dollar	do la My
domestic	vat nuoi trong nha, (thuoc) noi tro, quoc noi
dominate	chiem uu the, co anh huong, chi phoi; kiem che
door	cua, cua ra vao
dot	cham nho, diem; cua hoi mon
double	doi, hai, kep; cai gap doi, luong gap doi; lam gap doi
doubt	su nghi ngo, su ngo vuc; nghi ngo, ngo vuc
down	xuong
downstairs	o duoi nha, o tang duoi; xuong gac, tang duoi
downwards	xuong, di xuong
downward	xuong, di xuong
dozen	ta (12)
draft	ban phac thao, so do thiet ke; phac thao, thiet ke
drag	loi keo, keo le
drama	kich, tuong
dramatic	nhu kich, nhu dong kich, thich hop voi san khau
dramatically	dot ngot
draw	ve, keo
drawing	ban ve, buc ve, su keo
drawer	nguoi ve, nguoi keo
dream	giac mo, mo
dress	vay, quan ao, mac (quan ao), an mac
dressed	cach an mac
drink	do uong; uong
drive	lai , dua xe; cuoc dua xe (dieu khien)
driving	su lai xe, cuoc dua xe
driver	nguoi lai xe
drop	chay nho giot, roi, rot; giot (nuoc, mau...)
drug	thuoc, duoc pham; ma tuy
drugstore	hieu thuoc, cua hang duoc pham
drum	cai trong, tieng trong
drunk	say ruou
dry	kho, can; lam kho, say kho
due	den ky han (tra no); xung dang, thich dang
due to	do, tai, nho co
dull	cham hieu, ngu dan
dump	do rac; dong rac, noi do rac
during	trong luc, trong thoi gian
dust	bui, rac; rac (bui, phan), quet bui, phui bui
duty	su ton kinh, kinh trong; bon phan, trach nhiem
each	moi
each other	nhau, lan nhau
ear	tai
early	som
earn	kiem (tien), gianh (phan thuong)
earth	dat, trai dat
ease	su thanh than, su thoai mai; lam thanh than, lam yen tam
east	huong dong, phia dong, (thuoc) dong, o phia dong
eastern	dong
easy	de dang, de tinh, ung dung
easily	de dang
eat	an
economic	(thuoc) Kinh te
economy	su tiet kiem, su quan ly kinh te
edge	luoi, canh sac (dao)
edition	nha xuat ban, su xuat ban
editor	nguoi thu thap va xuat ban, chu but
educate	giao duc, cho an hoc; ren luyen
educated	duoc giao duc, duoc dao tao
education	su giao duc, su ren luyen (ky nang)
effect	hieu ung, hieu qua, ket qua
effective	co ket qua, co hieu luc
effectively	co ket qua, co hieu luc
efficient	co hieu luc, co hieu qua
efficiently	co hieu qua, hieu nghiem
effort	su co gang, su no luc
egg	trung
either	moi, mot; cung phai the
elbow	khuyu tay
elderly	co tuoi, cao tuoi
elect	bau, quyet dinh
election	su bau cu, cuoc tuyen cu
electric	(thuoc) dien, co dien, phat dien
electrical	dien
electricity	dien, dien luc; dien luc hoc
electronic	dien tu
elegant	thanh lich, tao nho
element	yeu to, nguyen to
elevator	may nang, thang may
else	khac, nua; neu khong
elsewhere	o mot noi nao khac
embarrass	lung tung, lam nguong nghiu; lam rac roi, gay kho khan
embarrassing	lam lung tung, ngan tro
embarrassed	lung tung, boi roi, nguong; mang no
embarrassment	su lung tung, su boi roi
emerge	noi len, hien ra; noi bat len
emergency	tonh trang khan cap
emotion	su xuc dong, su cam dong, moi xuc cam
emotional	cam dong, xuc dong, xuc cam; de cam dong, de xuc cam
emotionally	xuc dong
emphasis	su nhan manh, tam quan trong
emphasize	nhan manh, lam noi bat
empire	de che, de quoc
employ	dung, thuo ai làm go
unemployed	that nghiep; khong dung, khong su dung duoc
employee	nguoi lao dong, nguoi lam cong
employer	chu, nguoi su dung lao dong
employment	su thue muon
unemployment	su that nghiep, nan that nghiep
empty	trong, rong; do, doc; uong, lam can
enable	lam cho co the, co kha nang; cho phep ai lam go
encounter	cham chan, bat gap; su cham tran, su bat gap
encourage	dong vien, ung ho, giup do, lam can dam, manh dan
encouragement	niem co vu, dong vien, khuyen khich, su lam can dam
end	gioi han, su ket thuc; ket thuc, cham dut
in the end	cuoi cung, ve sau
ending	su ket thuc, su cham dut; phan cuoi, ket cuc
enemy	ke thu, quan dich
energy	nang luong, nghi luc, sinh luc
engage	hua hen, cam ket, dinh uoc
engaged	do dinh uoc, do hua hun
engine	may, dong co
engineer	ky su
engineering	nghe ky su, cong viec cua ky su
enjoy	thuong thuc, thich thu cai go, duoc huong, co duoc
enjoyable	thu vi, thich thu
enjoyment	su thich thu, su co duoc, duoc huong
enormous	to lon, khong lo
enough	du
enquiry	su dieu tra, su tham van
ensure	bao dam, chac chan
enter	di vao, gia nhap
entertain	giai tri, tiep don, chieu doi
entertaining	giai tri
entertainer	nguoi quan tru, nguoi tiep doi, chiou doi
entertainment	su giai tri, su tiep doi, chiou doi
enthusiasm	su hang hai, su nhiet tonh
enthusiastic	hang hai, say me, nhiet tonh
entire	toan the, toan bo
entirely	toan ven, tron ven, toan bo
entitle	cho tieu de, cho ten (sach); cho quyen lam go
entrance	su di vao, su nham chuc
entry	su ghi vao so sach, su di vao, su tiep nhan (phap ly)
envelope	phong bo
environment	moi truong, hoan canh xung quanh
environmental	thuoc ve moi truong
equal	ngang, bang; nguoi ngang hang, ngang tai,suc
equally	bang nhau, ngang bang
equipment	trang, thiet bi
equivalent	tuong duong; tu, vat tuong duong
error	loi, su sai sot, sai lam
escape	tron thoat, thoat khoi; su tron thoat, loi thoat
especially	dac biet la, nhat la
essay	bai tieu luan
essential	ban chat, thuc chat, cot yeu; yeu to can thiet
essentially	ve ban chat, ve co ban
establish	lap, thanh lap
estate	tai san, di san, bat dong san
estimate	su uoc luong, danh gia; uoc luong, danh gia
even	ngay ca, ngay, lai cun; bang phang, diem dam,ngang bang
evening	buoi chieu, toi
event	su viec, su kien
eventually	cuoi cung
ever	tung, tu truoc toi gio
every	moi, moi
evidence	dieu hien nhien, dieu ru ràng
evil	xau, ac; dieu xau, dieu ac, dieu tai hai
exact	chinh xac, dung
exactly	chinh xac, dung dan
exaggerate	cuong dieu, phong dai
exaggerated	cuong dieu, phung dai
exam	viet tat cua Examination
examination	su thi cu, ky thi
examine	tham tra, kham xet, hoi han (thi sinh)
example	thi du, vi du
excellent	xuat sac, xuat chung
except	tru ra, khong ke; tru phi
exception	su tru ra, su loai ra
exchange	trao doi; su trao doi
in exchange for	trong viec trao doi ve
excite	kich thich, kich dong
exciting	hung thu, thu vi
excited	bi kich thich, bi kich dong
excitement	su kich thich, su kich dong
exclude	ngan chan, loai tru
excluding	ngoai ra, tru ra
excuse	loi xin loi, bao chua; xin loi, tha thu, tha loi
executive	su thi hanh, chap hanh; (thuoc) su thi hanh,chap hanh
exercise	bai tap, su thi hanh, su thuc hien; lam, thi hanh, thuc hien
exhibit	trung bay, trien lom; vat trung bay, vat trien lom
exhibition	cuoc trien lom, trung bay
exist	ton tai, song
existence	su ton tai, su song
exit	loi ra, su di ra, thoat ra
expand	mo rong, phot trien, no, gion ra
expect	cho doi, mong ngong; lieu truoc
expected	duoc cho doi, duoc hy vong
unexpected	bat ngo, dot ngot, gay ngac nhien
unexpectedly	bat ngo, dot ngot, gay ngac nhien
expectation	su mong cho, su cho doi
expense	chi phi
expensive	dat
experience	kinh nghiem; trai qua, nem mui
bint	bint
trung	trứng thối
love	yêu đương
nnn	hola
